CLRT	Convention on Long-Range Transboundary Air Pollution
PM25	PM 2.5 emission
AGGN	Age group and Gender
AEGN	Age and Gender
WAS		Waste		
MUNI	Municipal Waste
DGD		Degree-days
HEAT	Heating
NAI		National Account Indicators
B006	National Accounts by 6 branches
B010	National Accounts by 10 branches
B064	National Accounts by 64 branches
TRA		Transaction
NFIN	Non-financial Transaction
HCP		HICP
CICP	Classification of individual consumption by purpose (COICP)
COUW	Country Weights
DEMI	Demographic Indicators
QUAN	Quantile
CRIM	Crime
PRIS	Prison
ICTS	ICT specialist skill
PRID	Products and Indicators
FAR		Farm
CRFR	Crop and Agricultural size of farm
CRIA	Crop and Size of irrigated area
OCA		Organic Crop Area
CRPR	Crop Product
FST		Forest Tree
DEFO	Defoliation
LNDG	Landing
VEH		Vehicle
APL6	6 air pollutants (SOx, NOx, NH3, NMVOC, PM10, PM2.5)
GHG6	6 greenhouse gases (CO2, N2O, CH4, HFC, PFC, SF6) in CO2 equivalents
GERN	Generation
PACK	Packaing
WEEE	Waste Electrical and Electronic Equipment
WSSE	Water Source and Sector
WH2		WasteWater
MATE	Material
NA		National Account
NUCI	Nuclear energy indicator
SUPP	Supply
INDC	Indicators
SPTC	Supply, transformation and consumption
SPTR	Supply, transformation
NE		Nuclear energy
EL 		Electricity
HT		Heat
ELEC	Electricity
INFL 	Inflation rate
ORG		Organisations
EMAS	Eco-management and audit scheme (EMAS) registration
OZON	Ozone
PACA	New passenger cars 
TR 		Treatment method
DMCO	Domestic material consumption
FEC		Final energy consumption
PR		Product
RE      Renewable
NR		Non-renewable
MFA		Material flow account
RMEQ	Raw material equivalents